А	AΑ
Б	Ƃ
В	BΒ
Г	Γ
Д	D
Е	EΕ
Ё	Ë
Ж
З	3	;Ɜ
И	Ͷ	;𝈋
Й
К	KΚ
Л	ɅΛ
М	MΜ
Н	HΗ
О	OΟ
П	Π
Р	PΡ
С	CϹ
Т	TΤ
У	
Ф	Φ
Х	XΧ
Ц	
Ч	4
Ш	Ɯ
Щ	Ϣ
Ъ	
Ы	
Ь	b
Э	℈
Ю	
Я
а	a	
б	6	;Ϭ
в	ʙ
г	ᴦ	ƨ
д	ɡ
е	e
ё	ë
ж	
з	ɜᴈ
и	ᴎ	uս
й	ŭ
к	ᴋκ
л	ᴧᴫ
м	ᴍʍ
н	ʜ
о	oοօ
п	ᴨ	nո
р	p
с	cϲ
т	ᴛ	m
у	y
ф	ɸ
х	x
ц	
ч	
ш	ɯա
щ	ϣ
ъ	
ы	
ь	
э	϶
ю	
я	ᴙ